%%%%%%%%%%%%%%%%%%%%%%%%%%%%%%%%%%%%
%  % %   %     % % %% % %    % %% P%
%  %     % %%%%   %% %%  % %   % % %
%%%%%  %%%%%   %   %%% %  % %%%    %
% %   %   %%% %%%%  %  % %% %     %%
%  %%%     %% %%  % %  %  % %  %% %%
% %    %%%% %%   % % % %%% %%% %  %%
%%%      %   %%%   %% %%%%%%   % % %
% % %% %%% %  %   %%  %%%% %%%  %  %
%% %    %   % %%  %%%     %        %
%%%%  % % %   %%%%%%  %     % %%  %%
%  %  %  %%  %        %     % % %% %
% %% % % %%  %%  %  %   %%   %% %% %
% %      % % %%    %  %  %%% %     %
%         % %    % %%%    %    %  %%
%%%      % %%       %% % %  %%  % %%
%       %% % %%%% %%     %    % % %%
%    %%%   % %  %       %%%%  %   %%
% % %%%  %   %  %%% % %  %%%  %   %%
%   %  % %         %%  %% %        %
%  %%%% %%% %      %% %% % %%%  %  %
%%%%     %%%  %%  %%  %   %  %     %
%% %%% %   %    %          %  %%   %
%   %% %%  %%    % %  %%  %    %%  %
% %  %%         % % %%%% %%     %%%%
%% %   %   %     %    % %%  %%% %% %
%    %  %%%% %%      %% % %%%% %  %%
%     %     %%%   %    %   %     % %
%  % %    %         % % % %  %     %
% %  %%   %  %   %%%     %%%%   %  %
%%    %%  %% % %  % % %  %   %     %
% %%%%  %      %  % %   %      % %%%
%%   %    % %  %% %%%%%%% %    %%%%%
%%   %% %%%% %      %%%  % %% %  % %
%.      % %%%     %%    %  %  % %% %
%%%%%%%%%%%%%%%%%%%%%%%%%%%%%%%%%%%%
