%%%%%%%%%%%%%%%%%%%%%%%%%%%%%%%%%%%%
%    %%  %%% %  % %%%%       %    P%
%  %  % % % %%%%          % %%  %  %
%%  %%%  %% %  % % %           % % %
%  %    %%  % %        %%%%%   %%  %
%     %   % %       % % %%   %%%%% %
% % % %%% % %      %    %% %% % %  %
%%%%% %   %  %  %%    %%%  %  %   %%
%% % %%        %   %%%% %%%  %%   %%
%    %   %   %  %  %% %%%% % %%    %
% % % %% %% %                 % %  %
%  % %% %%%    % %% %  % %%% %% %  %
%% %% %  %  %    % % % % % %       %
%%%  % % % %  % % %   %   %    %% %%
%  %   %% %   % %  %   %% %    %  %%
% %%%  %%  %% %  %%      %  % %%% %%
%   %%  %   %  %%    %    %%  %  %%%
%   % %%%%%     %  %%   %%%%%   %%%%
%%%   % %%    %  %  %%%%   % %  % %%
%  %    %%% % %%     %%%%%       %%%
%  %% %    %%% %  %%   %%%%% % % % %
%  %% %  %  %%  %   %    %%   %%%  %
% %      %  % %%   % % % % %%%% %% %
%   %  %  %%    %      %%       %% %
%% % %    %    %%  % % % %%%     % %
%  %% %  %%  %    %%  %%%% %%%     %
%   % %%        %   % %     %  %%% %
%   %  %%%%  %    %%% %% %%% %  %  %
%%       % %%%  %       %%%% %%%   %
%  % %          %  %%    %      %%%%
%%       % %% %%% %  %    %   %   %%
%% %  %  %%%% %%  %  % % % %%  % % %
%   %   %% % %% %      % % % %%   %%
% %%   %%% %  %%    %  %   %  % % %%
%.%   %  %% %       %  % %%    %  %%
%%%%%%%%%%%%%%%%%%%%%%%%%%%%%%%%%%%%
