%%%%%%%%%%%%%%%%%%%%%%%%%%%%%%%%%%%%
%%      % %% %% %   %%   %    % % P%
%  % %     %         %      %% %   %
%%%   % %%  %  %%%    % %   % %    %
% % %%   %%%%%%   %     % %%    %  %
%% %%    %    %%   %   %  %  %     %
%    %     %  % %    %  % %    % % %
%%%  %%  %   %   %%%  % % % %   %  %
%  %       %%  %%%    % %%    %  % %
%%%  %   % % %%% %     %      %  % %
% %%  %     %%  %      %%%  %  %%  %
%%    % %% %  %        %   %%%     %
%%%   %     %%   %%% % %    %%%%  %%
%% %%  %  %% % %%   %  %   % % %  %%
%%        % %%%  % %  %   % %      %
%      % %  %    %  % %  %%   %%%% %
%    %   % %%  %%%%   %     %     %%
%   %%  %     % %  %   % %    %%% %%
%     %%%  % % % %%    %  % %%   % %
% %%   %%%  %%%%%     % %    %%% % %
% %     % % %  %  %%  % % %  % % % %
%  %%%      %  %%     %   %  % %   %
% %%% % % %   %  %%      %   %     %
%    %% %                   %%  % %%
%  %%% %   % %%    % %    %%     % %
%%  %  %%%%%% %% %    % %   % %%%  %
%  % %%%%%  %%     %%   %  % %   %%%
%       %%  %  %%  %% % %%%% %%    %
% % %   %%     %%  % %%% %%  %   % %
%   %%% %%%%% %%%%%      %  %% %% %%
% %         %% %  %   %    %    %  %
%    %%%     % %      %%     %    %%
%  %% %     %  % % %%  %% %%  %%   %
%%             %        %         %%
%.  %  %   %%%%% %   %   %% %      %
%%%%%%%%%%%%%%%%%%%%%%%%%%%%%%%%%%%%
