%%%%%%%%%%%%%%%%%%%%%%%%%%%%%%%%%%%%
%        %%  % % % %     %%   %   P%
%    %  %  %%  %  %  %   %%      % %
%  %  % %    %  %%%%%   %   %   %% %
%   % %    %  % %%%%%% % %   % %   %
%       %% %   % %  % %%% % %   %% %
%  %%% % % %    %  %  % % %%  % %  %
%% %%% % %  %%  %%%% %%%%% %       %
% %%%% % %% %    %%   %%    % %   %%
%    %   %     %        %     %    %
%  %   %   %   %      %     %     %%
%  %     %% %       %      %    %%%%
% %    %  %% %%% %   %%     %  %%  %
%% %% %%       %       % %%%% % %%%%
%% %% %    %% %  %%  %   %%% %  % %%
%       %%   %%   % % %  %%  % %   %
%%  %     %%   % % %%%    %        %
%% %% %%  %  %    % %%%     % % %% %
%%   %%    %% % % %  %%    %  %%% %%
%% %%%% %   %    %%    %  %  %  %%%%
% %    %   %% %  % % %%        %  %%
%     %%%%%  % %   %%  %   %   %%% %
%%%    %%%% %% %% % %    % %  %% %%%
%% % %%      %% %   %   %   %% %%  %
% %% %% %% % %% %%  %  %  % % %   %%
%   % %             %% %%   % %    %
% %% %   %  %%%%   %   %          %%
% % % %%%    %  % %%  %% %% %      %
% %  %  % % %  %      %  %%   %%%% %
%%        % %%     %%%    %  %%%   %
%%   %%%         %%%%  %  %%% %    %
%  %%%% %  % % %%     %%%     %  % %
%  %  %  %      %% %%  % %    %%   %
%%  %%% %% % %% %   %% % %%  %%% % %
%.  %% % %   % %  % %%%%  % %%%%   %
%%%%%%%%%%%%%%%%%%%%%%%%%%%%%%%%%%%%
