%%%%%%%%%%%%%%%%%%%%%%%%%%%%%%%%%%%%
% %%%  %%  %  %          %    % % P%
%  %            %      %%   %     %%
% %   %  %         %%    %     %   %
% %% %  %%   % % % %    % %  % %  %%
% %% % %% %%%  % %    % %  %   %%  %
%% %    % %%% %%     %%    %% %% % %
%%%   %% %%% %%% %     %   %% %% % %
%  %     % %%    %  %%% %%     %%%%%
%% %  %     %    %   %  % %  %%   %%
%   %% % %%      %     %  %%   % %%%
%   %          %   %   %% %    %   %
%     %  % %%  %   %%%        %   %%
% %%%% %%  %        %%%%%% %%%%%% %%
%%%  %  %  %%%%% %   % %% %  %% % %%
%%%     %%      %  %  % %          %
% % %    %%%% %% %     %      %   %%
%%%    %%%    %   %% %  %%%%% %%   %
%   %     % %%%% %%%  %%   %    %% %
%   % %   % %%  %     %%    %   %  %
%%%%     % %   % %    %       % %%%%
%   % %%   % %%  %%%     %%% %%%%  %
%       %% %   %     %%   %  %%% %%%
% % %%%  %% %%%% %  %  %    %      %
%     %% %  %    %  % %  %%%    %%%%
%%     % % %   %%  %  %%% %%%%%  % %
%% %%  %   %  %%   %   %%  % % %  %%
%%%%    %%%% %%   %%    %  %%%  %  %
%%   % % %%% % %  % % %%%% % %   % %
%    % %   % %      %    %% %    % %
%   %%         %% %% %    %% %%   %%
%%%   %  %   %  %%    %%% %%   %%%%%
% %    % %     %      %  %     %  %%
% %    %%%%    %%%  %%%    %% %%  %%
%.   %   %%    %    %   %   %%    %%
%%%%%%%%%%%%%%%%%%%%%%%%%%%%%%%%%%%%
