%%%%%%%%%%%%%%%%%%%%%%%%%%%%%%%%%%%%
%%% % % %% %% %% %%% % %      % %%P%
%  %    %   %%  %%   %%  % %  %%   %
%%%%      % %          %   %%  %  %%
% %%  %%%% %    %  %%% %% %%% %%%  %
% %   %%   %%    % %        %%%%   %
%%%  % %% %   %% % % %% %     %    %
%%          %   %         % %     %%
% %  % %% %%%%  % %% %% %% %%%     %
%%  %%%  %%   %   %  %       %%%%%%%
%    %%  %%     %         % % % % %%
% %    %%%   %% % %% % % %%%      %%
%   % %   %%  %   %       %%    % %%
%%  % % %%%   % %% %%%   %%% %    %%
%   %% % % % %   % %  %    %  % % %%
%    % %%% %%%%    %       % %   %%%
%     % % %      %   %% %  %       %
%%  %  %  %% %  % %%     %     %%% %
%%% %%%%   % %%  %%% %%  % % %%%% %%
%  %% %% %%           %  %%   %%   %
%%% %      % % % %%%%   %%%%       %
% %  % %  %   % %% %% % % %%  %    %
%%%    %     % % %%%  %            %
% %%%%%  % %   %    %%%  %%% %  %% %
%%%%  %  %% %   %   %     %%   %  %%
%%      % %%      %     %    % %% %%
%  %  %% %% %      %%%%%  %%% %%%  %
%%%  %%  %%%%%  %   %% % %      %  %
%     %     %  %%%    %%%% %  %  % %
%% % %% %%%  %%%%       % %%  %%   %
%%  %          %     %%% %%%  %    %
%%    %%  % %% %  %% %      %   %% %
% % %  % %   % % %%%%% %  %     %  %
%%%%  % %   %% % %%% % %%%% % %%%  %
%.     % %%%%%% %  % % %  % %      %
%%%%%%%%%%%%%%%%%%%%%%%%%%%%%%%%%%%%
