%%%%%%%%%%%%%%%%%%%%%%%%%%%%%%%%%%%%
%     %% % % %  %    %   %%  %%   P%
% % %  %    % %    % %  %%      %% %
% % %  %        %%%%   % %%   %%  %%
% % %   %%%   %   %% % % %         %
% %%  %% %%%% %  %   %     % %% % %%
% %%%  %% %     %% %%     %  %%  % %
% % %         % %  %   %% %  %     %
%  % % %   %    %%  %  % % %  %  %%%
% %%%%  % %  %   %%         % %%%%%%
% %   %% %% % %%%%  % %  % % %  % %%
%    %  %  % % % %% %%%   %   %%%% %
%%  %%%%%    % % %    %  %  %  %% %%
%   %%   %   %      %   %%%   % % %%
%  %%    %%      %    %%% % %   %  %
%% %   %%% %       %%% %%  % % % % %
%   %      % % %%%% %% %%   % %  % %
% %  %%%  %%    % %  %%   %  %  %  %
%  %     %%   % %%   %% %  %  %%   %
%% %%%%    % %%  % % %%   %%   %%% %
%   %     %%%% %%%    %%%     %  % %
% %  %% %%% %   %%  %  %    %     %%
%  % %  %     %%   % %%%   % %   % %
%%%  % %%   %              % % %  %%
%  %%  %  %        %  %%%%%%    %% %
%  %% %%     %      %   %  % % % %%%
%     %  %%  %% %%  %% % %%  %  %%%%
% %   %  %     %%%%%% %     %%   % %
%     %   % %  %%%  %         %%  %%
% %%       %   %  %%  %   %%     % %
%%    % % %%       %  % %   %%%%%  %
%       %%%   %%%% % %    %      % %
%%% %%%%  %%       %%        %%%  %%
%  %%%        %%  %%       % % %   %
%.     %  %     %       %  %%  %   %
%%%%%%%%%%%%%%%%%%%%%%%%%%%%%%%%%%%%
