%%%%%%%%%%%%%%%%%%%%%%%%%%%
%    % %   % %   %% %    P%
%%  %%    % %%  % %%  % %%%
%      %%       % %%  %% %%
% %% % %%% %%  %%%%    % %%
%     % %     %%%   %%    %
%   %%%%%%  %%% % % %%   %%
%        %          %   % %
%%% %  %%%  %% % %  %%%% %%
%  %   %% % %             %
%%%   % % %%   %%   %%%%%%%
%    %          %%% % %   %
%%%   %      % %      %   %
%     % %   %%  %   % % % %
% % %%     %  %% %%       %
%%%    %     %%   %  %  % %
%.  %  % %%  %  %%        %
%%%%%%%%%%%%%%%%%%%%%%%%%%%
