%%%%%%%%%%%%%%%%%%%%%%%%%%%
%  % % % %   %% % % %    P%
% % %  %  %  %%  %%% % %  %
%%%%%  %  % %  %  % %%%% %%
%% %%%%     % %% %%%%%%   %
%    %   % %  %    %  % % %
%%%% % %% %% %     %   %% %
%%% %%   %   % %%  %      %
%%    %   %%  %%      %   %
% %    % %  %       %%  %%%
%% % %%  % %        % %   %
% %      %% %    %%   %%%%%
%      %%%%    %  % %%    %
%    %%%   % %%   %   %%% %
% %% %   %  % % %%  %%    %
%       % %   %  %  %%   %%
%.%%      %         %  %%%%
%%%%%%%%%%%%%%%%%%%%%%%%%%%
