%%%%%%%%%%%%%%%%%%%%%%%%%%%
%   %% % %%  %% %%    % %P%
%   %%  %   %%%    %%     %
%          % %  % %  % %  %
%%       %%%%%   %%%%  % %%
%  %%% % % % %     %%     %
%%   % %    %%% %   %    %%
%      % % %  %    %% % % %
%  %%%%% %%%%%  %%   %    %
% % %        %   %%    % %%
%  %                  %   %
%%  %%% %%    % %%% %     %
%  %% %  %     % % %% %%% %
%  %           %   %     %%
%   %% % % % %     %%% %%%%
% % %  %   %  %  %%%  %%% %
%. %%      %%%%% %      % %
%%%%%%%%%%%%%%%%%%%%%%%%%%%
