%%%%%%%%%%%%%%%%%%%%%%%%%%%
%  % %%     %%%%   %%%%% P%
%% %%  %%         %  %   %%
%% %%    %%  %    % %%%%  %
% %%  %%  %   % %%% %%%   %
%  % % % %  %%% %%% %%%   %
%     %    %%   %%        %
% %% % %  % %  %  % %%% %%%
%     %      %        %   %
%%% % %%  %% %%  %    %   %
%% %  %  %% %% % %     %% %
%    %%%     %%    %% %% %%
% %%%  % %    % % %% % % %%
% % %   % % % %   %%   %  %
%       %     %%  %%  %  %%
%   % % % %       %   % % %
%. %   %  %  %%   %%  %   %
%%%%%%%%%%%%%%%%%%%%%%%%%%%
