%%%%%%%%%%%%%%%%%%%%%%%%%%%
%    %   %  %   % %%% %  P%
%  %% %%%%  %      % %%   %
%%   % %    %%%%    %   % %
%%% %%          % %%%   %%%
% % %   %%%    %      %   %
%     %   % %    %% %%    %
%  % % %  %% %       % % %%
%%  % %       %% %%   %%  %
%% %  %  % % %  % %%    %%%
%%    % %%  %    %% %% %% %
%   %%% %%% %% %%  %%%    %
% %% %  %   %%%      % % %%
%  %   %  % %   %%%   %   %
%%  %    %   % %%  %% % % %
%    %% %% %%  % %   %   %%
%.%    %   %%% %     %  %%%
%%%%%%%%%%%%%%%%%%%%%%%%%%%
