%%%%%%%%%%%%%%%%%%%%%%%%%%%
%%      %       %%% % % %P%
%% %%%  %    %% %%%%  %   %
%%%   %  % %    %        %%
%  % %   %     %%      %  %
%%% %        %        %  %%
% % %% %   %    %%   %% % %
%  %%%     % %  %%        %
% % % % %        %%% %    %
%  %% %    % % % % %      %
%%      % % %%%% %%  % %  %
% %  %%    %  %  %   %%%  %
%% %   % %  % %  %      % %
%  %%%   % %%% % % %% % % %
%  %%   % %   % % %%  %  %%
%   % %% %         %%%%  %%
%.%   %   % % %    %   %  %
%%%%%%%%%%%%%%%%%%%%%%%%%%%
