%%%%%%%%%%%%%%%%%%%%%%%%%%%
%% %%% %  %%    % %%%  % P%
%%%    % %     % %  % %% %%
%%      %%%%    %% %   %  %
%    % %%%    % %  %  % % %
% %%   % %%%%      %% %%  %
%  %%%%   %%%% % % %% %%  %
%  %%                 %   %
%% %  % %  %  %  %  %    %%
%     %  %    %  %% %  %% %
% %  %% %     %  %   %%  %%
%    %%  % %    %%%  %% % %
%%  %% %%  %%  %  %% %    %
%           % %%        % %
%  % %% %     % % %% %  %%%
%% %%%  %%% %  %  %     %%%
%.   %    %    %%%   % % %%
%%%%%%%%%%%%%%%%%%%%%%%%%%%
