%%%%%%%%%%%%%%%%%%%%%%%%%%%
%  %  %%    %% %% %   %%%P%
%      %    %  %%  %      %
%%%%  % %% %      %%%% %  %
%%  % %  %     %  %       %
%    %     %%  %%%    % % %
%     %%   % %%%%   %%    %
%% %%  %       %  %  %  %%%
%%% %%   %%  %  %   %  %%%%
%   %    %   % %% %%%% %% %
%   %     %%  %% %%% %  % %
%%%   % %% %   %  %    %%%%
%    %% %%      %    %    %
%% % % %% %     %   %%%   %
%%  % %   %     %%%%  % % %
%      %   %%%%         %%%
%.           %  %%  % %  %%
%%%%%%%%%%%%%%%%%%%%%%%%%%%
