%%%%%%%%%%%%%%%%%%%%%%%%%%%
%    %%% %    %%% % %% % P%
%   % %   %%% %     %   % %
%  %   %%     %         % %
% % %       %   %% %   %% %
%%%% % %%%    % %%%  %%%  %
%%     % %        %%%  %  %
%   %  % %     %%  % %%  %%
%%% % %%    %  %%%%%      %
%   %%% % %%  %   %  % %% %
%%%  %% %%  %        % %% %
%  %  %  % % % %%   %%%  %%
% %%% % %    % %%% % %% % %
%%%      %%  %%% %%% % %  %
%     %%  %   %% %% %% %% %
%  %%   %%   %% %%%%%%%  %%
%. %  % %      %%         %
%%%%%%%%%%%%%%%%%%%%%%%%%%%
