%%%%%%%%%%%%%%%%%%
%      %%       P%
%% % %%%  %    % %
% %  %    % %% % %
%%      % % % %% %
% %%%% %  %      %
%   %     %  %% %%
%.%    %    %%  %%
%%%%%%%%%%%%%%%%%%
