%%%%%%%%%%%%%%%%%%
%%%%    % %  %  P%
%%           %%  %
%%   %%  %%      %
%   %   %  % %% %%
% % %    %     % %
% %     %    %%  %
%.     % %   %  %%
%%%%%%%%%%%%%%%%%%
