%%%%%%%%%%%%%%%%%%
%%              P%
%%   %  % % %    %
%        %  %   %%
% % %% %   %     %
% %  %   % %  %  %
%%         %  %% %
%.         %%%%%%%
%%%%%%%%%%%%%%%%%%
