%%%%%%%%%%%%%%%%%%
%%%    %    %%  P%
% % %% % %   %  %%
%        %%%   % %
%    %  %        %
%   %  %       %%%
% %%  %      % % %
%.  %%%%   %%%%%%%
%%%%%%%%%%%%%%%%%%
