%%%%%%%%%%%%%%%%%%
%  %      % %   P%
%%         %  %  %
%%  % %   %   %% %
%  %%%       % % %
%   %       %%   %
%%   %%  % % % % %
%. %   %%%      %%
%%%%%%%%%%%%%%%%%%
