%%%%%%%%%%%%%%%%%%
% %       %% %% P%
%%%   %  % % %%% %
% %% %% %   %%   %
%    %  %   %  % %
%%  %%        %% %
%  %  %%% %  %  %%
%.%  % %%%% %    %
%%%%%%%%%%%%%%%%%%
