%%%%%%%%%%%%%%%%%%
%  % %  %% %  % P%
% %%  %    %% %% %
%         %      %
% %%%    %  %%% %%
% %   %% %%  %  %%
%% % %       %%% %
%.     %  %%%%  %%
%%%%%%%%%%%%%%%%%%
