%%%%%%%%%%%%%%%%%%
% %   %  %% %   P%
% %%%%%%%  %% %%%%
% %  %  %   %  % %
%%    %  %     % %
%% %  %%%%%%%   %%
%% %%            %
%. %%%  %%%%% %  %
%%%%%%%%%%%%%%%%%%
