%%%%%%%%%%%%%%%%%%
%   %% % %% % %%P%
%%%  %     %%%   %
%   % %% %%  %%  %
%  %%% %%   %% % %
%    %%%  %   %% %
% %   %  %% %  % %
%.          %    %
%%%%%%%%%%%%%%%%%%
