%%%%%%%%%%%%%%%%%%
% %%  % %%%%  % P%
%   % %% %%%     %
%%    % % %%     %
%  %      %%  %% %
% % %   %    % % %
% %%%%  %    %   %
%.    % % %  % % %
%%%%%%%%%%%%%%%%%%
