%%%%%%%%%%%%%%%%%%
%%%% %%  %  %  %P%
%  %%% % %  % %  %
%%     %%  %   % %
%  %%% %     %   %
%%       %   %%  %
%  %  % % %%    %%
%.%%     %%   % %%
%%%%%%%%%%%%%%%%%%
