%%%%%%%%%%%%%%%%%%
% %    %      %%P%
%   %    %%  %   %
%% % % % %  % % %%
%  %%% %   %    %%
%   %% %%  %%    %
%   % %  %     %%%
%.   % %  %  %   %
%%%%%%%%%%%%%%%%%%
