%%%%%%%%%%%%%%%%%%
% %   %   % %% %P%
%%  % %% %     % %
%  %     %    %  %
% % % %%     %  %%
%   % %    %%%% %%
% %   %         %%
%.% % % %% %%   %%
%%%%%%%%%%%%%%%%%%
