%%%%%%%%%%%%%%%%%%
%%%  %  %%     %P%
% %  %% %   %%%  %
%    %%          %
%    %% % %%    %%
%        % %% %% %
% %  % %   %    %%
%.%  %%    %%%  %%
%%%%%%%%%%%%%%%%%%
