%%%%%%%%%
%    %%P%
%  %    %
%   % % %
% % %%  %
%%%    %%
%%  % % %
%. % %% %
%%%%%%%%%
