%%%%%%%%%
%   %% P%
%%  %   %
%  %    %
%%  %  %%
%      %%
% % % %%%
%.% %%% %
%%%%%%%%%
