%%%%%%%%%
%%% % %P%
%  %%%  %
%%     %%
%   %   %
%    %  %
%   % % %
%.  % % %
%%%%%%%%%
