%%%%%%%%%
%    % P%
% % %% %%
%%  %% %%
%%      %
%% % %  %
%     % %
%.%%   %%
%%%%%%%%%
