%%%%%%%%%
% %%% %P%
%%% %   %
%%%  %  %
%%      %
%% %   %%
%%%     %
%.   %% %
%%%%%%%%%
