%%%%%%%%%
%%    %P%
%  %%   %
%  %%%% %
% %  %  %
% %%%  %%
%       %
%.%%%   %
%%%%%%%%%
