%%%%%%%%%
%%  %  P%
%%%    %%
%     %%%
%      %%
%%    % %
%    %  %
%.  % %%%
%%%%%%%%%
