%%%%%%%%%
%      P%
%%% %  %%
%   %%% %
%   %   %
% % %   %
%%     %%
%. %  % %
%%%%%%%%%
