%%%%%%%%%
%%     P%
%% % %  %
%%%  %%%%
% %%   %%
%% % %%%%
%     % %
%.%% %% %
%%%%%%%%%
